0 0 20 20
..###################
........#.....#.....#
#.#.#.###.###.#.###.#
#.#.#.#.#...#.#.#...#
###.#.#.#.#.#####.#.#
#...#.#.#.#...#...#.#
###.#.#.#.###.#.#.###
#...#.....#.#...#...#
#.#########.#######.#
#.#...#.........#...#
#.#.###.#.#.###.###.#
#...#.#.#.#...#.....#
###.#.###.#.#####.#.#
#.......#.#.#...#.#.#
###.###.#.#.#.###.###
#.....#.#.#.#.....#.#
###.#########.#.###.#
#.#...#.......#.....#
#.#.#.#.#####.#.###.#
#...#.#.#.....#.#...#
###################.#
